NO ./textures/texture_1.xpm
SO ./textures/texture_2.xpm
WE ./textures/texture_3.xpm
EA ./textures/texture_4.xpm

F 22023,100,0
C 225,30,0

111111111111111111111111111111
100000000N00000000000000000001
100001000000111111111111111111
1000000000000       1
1000000000000   1
10000000111        0000011
100000001              0
111111111