NO ./textures/texture_1.xpm
SO ./textures/texture_2.xpm
WE ./textures/texture_3.xpm
EA ./textures/texture_4.xpm

F 220,100,0
C 225,30,0

111111111111111111111111111111
10000000000d000000000000000001
100001000000111111111111111111
1000000N000001
10000000000001
1000000011111
100000001
111111111